00011000001
00100000111
01010111100
10101100001
10010000000
00110010000
00100101000
00100010100
01100001010
01000000101
11010000010
