00000000000011
00100000100000
01010000000000
00100000010000
00000100000100
00001001000000
00000000000001
00000100100000
01000001001000
00010000000100
00000000100100
00001000011010
10000000000100
10000010000000
