01110010
10001100
10011110
10100000
01100000
01100001
10100001
00000110
