01000010000
10000110010
00011000100
00101001100
00110001000
01000000001
11000001001
00011010010
00110000000
01000001000
00000110000
