001100000000
000001100100
100000001010
100011000000
000100010010
010100000000
010000000001
000010001000
001000010000
010000000001
001010000000
000000100100
