0000000000010000001
0000000000000011000
0000000000000110000
0000000000010001000
0000010000000100000
0000100000100000000
0000000100001000000
0000001000100000000
0000000000000000101
0000000000000000110
0000010100000000000
1001000000000000001
0000001000000000010
0010100000000000000
0110000000000000000
0101000000000000000
0000000011000000000
0000000001001000000
1000000010010000000
