000000001000001000010000
000000001000010000000000
000100000001000000000000
001010000000000000000000
000100000000000001000000
000000100001000001000100
000001000000110000000001
000000001000001000010000
110000010100000000000000
000000001011100000000000
000000000101000000000000
001001000110000000000000
000000100100000000000000
010000100000000000000000
100000010000000000000000
000000000000000000011000
000000000000000000001001
000011000000000000000000
000000000000000000000011
100000010000000100000001
000000000000000110000000
000001000000000000000010
000000000000000000100100
000000100000000010110000
