0000010100
0000110101
0001000010
0010100000
0101000100
1100000000
0000000100
1100101000
0010000001
0100000010
