0000010010
0001001111
0001000100
0110100100
0001011000
1000101010
0100110010
0111000000
1100011001
0100000010
