00000000000000001010010000
00000000000001010000000000
00010110000000000000000000
00101100000000000000000000
00010100000000000000000011
00111000000000100000000000
00100001000000100000000000
00000010000001100000000000
00000000010110000000000000
00000000101000000000000000
00000000010100000000000000
00000000101001010000000000
00000000100001000000000000
01000001000110100000000000
00000111000001000000000000
01000000000100000000000000
10000000000000000100000001
00000000000000001010000000
10000000000000000101000000
00000000000000000010100100
00000000000000000001010000
10000000000000000000101000
00000000000000000000010100
00000000000000000001001001
00001000000000000000000001
00001000000000001000000110
