01000100
10101001
01001010
00001101
01110001
10010010
00100100
01011000