00001100
00100110
01000100
00000101
10000011
11110000
01001000
00011000
