0000011010
0001000011
0000000111
0100100000
0001000101
1000000100
1000000000
0010110010
1110000100
0110100000
