01000010
10000011
00011110
00101011
00110100
00101010
11110101
01010010
